NO ./texture/mur-bleu.xpm
SO ./texture/mur-rouge.xpm
WE ./texture/mur-vert.xpm
EA ./texture/mur-jaune.xpm
C 120,200,250
F 224,205,169

1111111111111111111111111111111111111111111111111111111111111111111111111111111111111111111111111
1000000000000000000000000000000000000000000000000000000000000000000000000000000000000000000000001
1000000000000000000000000000000000000000000000000000000000000000000000000000000000000000000000001
1000000000000000110000000001111000000001110000110000000001100000000001111111000000000111111100001
1000000000000011111000001110000111000001111000110000000001100000000011000000000000000110000000001
1000000000001100111000000000111000000001101100110000000001100000000011000000000000000110000000001
1000000000111001110000000111000000000001100110110000000001100000000011000000000000000111111100001
1000000011111111111000111000000000000001100011110000000001100000000011000000000000000110000000001
1000000000000111000011100000000000000001100001110000000001100000000011000000000000000110000000001
1000000000001110001111111111100000000001100000110000000001100000000001111111000000000111111100001
10000000000000000000000000000000000N0000000000000000000000000000000000000000000000000000000000001
1000000000000000000000000000000000000000000000000000000000000000000000000000000000000000000000001
1111111111111111111111111111111111111111111111111111111111111111111111111111111111111111111111111