



NO ./texture/mur-bleu.xpm
SO ./texture/mur-mauve.xpm
WE ./texture/mur-orange.xpm
EA ./texture/mur-gris.xpm
C 1,200,250
F 224,205,169




111111111111111111111111111111111111111111111111111111
100000000000000000000000000000000000000000000000000001
100000000000000000000000000000000000000000000000000001
100000000000000000000000000000000000000000000000000001
100011111000111110001000100011111000111110001000100001
100010000000100010001000100010000000100010001000100001
100010000000100010001000100010000000100010001000100001
100010000000100010001000100010000000100010001000100001
100011111000111110001111100011111000111110001111100001
100000000000000000000000000000000000000000000000000001
10000000000000000000000000N000000000000000000000000001
100000000000000000000000000000000000000000000000000001
111111111111111111111111111111111111111111111111111111
