NO ./texture/mur-bleu.xpm
SO ./texture/mur-rouge.xpm
WE ./texture/mur-vert.xpm
EA ./texture/mur-jaune.xpm

C 120,200,250
F 40,40,40
11111111111111111111111111111111111111111111
10000000000000000000000000000000000000000011
10000000000000000000100000000000010000000011
10000001000000000000000000000000000000000011
10000000000000001111110000000000000000111111
10000000000000000000000000000000001000000011
10000000000000000010000000000000000000000011
10000000011100001111101111110000000000111111
10010000011100000110101101110000000000000001
10000000011100000000101100000000001000000001
10000000011100001011100011110000000000101111
10000000011100000000000000000000000000000001
10000100011101001011101110110000000000100001
10000000011100001100000000000000000000000001
10000000011100001011101011110000000000000001
10000000011100001111101111110000000000000001
10000000000000000000000000001000000000000001
10000010000000000000000000000000000000000001
10000000000000100000000000000000000000000001
100000000000000000N0000000010000000001000001
10000000001000000000000000000000000000000001
10000000000000000000000000000000000000000001
11111111111111111111111111111111111111111111
