NO ./texture/mur-bleu.xpm
SO ./texture/mur-rouge.xpm
WE ./texture/mur-vert.xpm
EA ./texture/mur-jaune.xpm
F 220,100,0
C 225,30,0


01111111111111111111111111
1000000000110000000000001
1011000001110000000000001
1001W000000000000000000011111111
1111111110110000011100000000000001
10000000001100000111011111111111
11110111111111011100000010001
11110111111111011101010010001
1100000011011011100000010001
1000000000000001100000010001
10000000000000001101010010001
110000011101010111110111100111
11110111 1110101 101111010001
11111111 1111111 111111111111                                      0
