NO ./texture/mur-bleu.xpm
SO ./texture/mur-bleu.xpm
WE ./texture/mur-bleu.xpm
EA ./texture/mur-bleu.xpm
F 50,50,20
C 30,50,155

1111111111
1000000001
1000000001
1000000001
1000100001
1000S00001
1000000001
1000000001
1000000001
1000000001
1111111111
